111111111
100000101
1E0011011
100PC1001
100001011
111111111