111111111111111111111111111111111111111111111111111111111111
100000000000000011000001C11000000000001100000000010000000101
10000000111100000000000001C110000000000000000000010000000011
1000000000000000000001C1100000000000000000000100000011110011
10000001111000000000000001C110000000000000000000010000000101
1000000000000000000001C1100000000000000000000100000111100001
10000000111100000000000001C110000000000000000000010000000001
10000000011110000000000001C110000000000000000000010000000111
10000000000111100000000001C110000000000000000000010000000111
1000000000000000000001C1100000000000000000000000010011000111
1000000000000000000001C1100000000000000000000100000011110111
1000000000000000000001C1100000000000000000000101111000000011
1000000000000000000001C1100000000000000000000000010000000011
100000000000000000000000000000000000000000000000010000000011
1000000000000000000001C1100000000000000000000100000000000011
1000000000000000000001C1000010000000000000000000010000000011
1000000000000000000001C0000100000000000000000000100000010011
1000000000000000000001C1100000000000000000000100000001000101
1000000000000000000001C1100000000000000000000100001101000101
1000000000000000000001C1100000000000000000000101101000001001
1000000000000000000001C1100000000000000000000100000101000011
1000000000000000000001C1100000000000000000000100000000101011
100000000000000000000000000000000000000000000100000010011001
1000000000000000000001C1100000000000000000000000000011110101
100000000000001100000001C11000000000000000000001000000010001
1000000000000000000001C0000000000000001100000001000110010001
1000000000000000000001C1100000000000000011000001000011101001
100000C00000001100000000C11111111100000000000001000011111001
1000000000000000000001C1100000000000000000000100111100000001
100000000000110000000000C11000000110000000000000010000110001
1000000000000000000P01C11001100000000E0000000001001100000001
1000000000000000000001C11001100000000C0000000001001100000001
111111111111111111111111111111111111111111111111111111111111
