111111111
1P0000101
1E0011011
1000C0001
1000C1C11
111111111