11111111111
10000PEC001
11111111111