111111111
1E00P1011
100C0P011
111111111