1111111111111
1P00001000001
1E00110100001
1000C10010001
10000101001E1
1111111111111