1111111111111111111
1P00001101011100001
1E00110000101011011
1000010000000000001
1000000100000000001
1111111111111111111