111111111
100000101
1E0011011
1000C1001
100001011
111111111