111111111
1P0000101
1E0011011
1000C1001
100000011
111111110