111111
1P0001
1E0011
100001
10C011
111111