111111111
1P0000101
1E0011011
1000C1001
100001011
1111111111111