111111111
100001101
1E0011011
1000C1P01
100001011
111111111